school	Schule
university	Universität
work	Arbeit
hospital	Krankenhaus
library	Bibliothek
dentist	Zahnarzt
doctors	Ärzte
factory	Fabrik
hair dresser	Friseur
police station	Polizeistation
butchers	Metzgereien
bakers	Bäckereien
grocers	Lebensmittelgeschäft
market	Markt
supermarket	Supermarkt
home	Zuhause
skyscraper	Wolkenkratzer
pub	kneipe
nightclub	Nachtclub
park	Park
swimming pool	Pool
ice rink	Eisbahn
gym	Fitnessstudio
farm	Bauernhof
cafe	Cafe
restaurant	Restaurant
church	Kirche
cathedral	Dom
mosque	Moschee
synagogue	Synagoge
garage	Garage
motorway	Autobahn
village	Dorf
town	Stadt
city	Stadt
country	Land
countryside	Landschaft
shoe shop	Schuhladen
bank	Bank
arcade	Arkade
mall	Einkaufszentrum
stadium	Stadion
forest	Wald
beach	Strand
