aardvark	aardvark
alligator	alligatore
anaconda	anaconda
ant	formica
anteater	formichiere
antelope	antilope
baboon	babbuino
badger	tasso
bat	pipistrello
bear	orso
beaver	castoro
bee	ape
beetle	scarafaggio
bird	uccello
bison	bisonte
boar	cinghiale
buffalo	bufalo
bull	Toro
butterfly	farfalla
camel	cammello
cassowary	casuario
cat	gatto
caterpillar	bruco
cheetah	ghepardo
chicken	pollo
chimpanzee	scimpanzé
cobra	cobra
cockerel	galletto
cockroach	scarafaggio
cow	mucca
crab	Granchio
crane	gru
cricket	cricket
crocodile	coccodrillo
crow	corvo
deer	cervo
dog	cane
dolphin	delfino
donkey	asino
dove	Colomba
dragonfly	libellula
duck	anatra
eagle	aquila
eel	Anguilla
elephant	elefante
emu	emu
falcon	falco
ferret	furetto
firefly	lucciola
fish	pesce
flamingo	fenicottero
fly	volare
fox	Volpe
frog	rana
gazelle	gazzella
gecko	geco
gerbil	gerbillo
giraffe	giraffa
glow worm	lucciola
goat	capra
goose	Oca
gorilla	gorilla
grasshopper	cavalletta
grouse	gallo cedrone
guinea pig	porcellino d&#39;India
hamster	criceto
hare	lepre
hawk	falco
hedgehog	riccio
hen	gallina
heron	airone
hippopotamus	ippopotamo
hornet	calabrone
horse	cavallo
hummingbird	colibrì
hyena	iena
iguana	iguana
jaguar	giaguaro
jellyfish	Medusa
kangaroo	canguro
killer whale	balena assassina
koala	koala
ladybird	coccinella
lemur	lemure
leopard	leopardo
lion	Leone
lizard	lucertola
llama	lama
lobster	aragosta
locust	locusta
meerkat	meerkat
mole	Talpa
monkey	scimmia
moose	alce americano
mouse	topo
mosquito	zanzara
moth	falena
narwhal	narvalo
newt	tritone
octopus	polipo
orca	orca
ostrich	struzzo
otter	lontra
owl	gufo
oyster	ostrica
panther	pantera
parrot	pappagallo
panda	panda
peacock	pavone
pelican	pellicano
penguin	pinguino
pig	maiale
pigeon	piccione
platypus	ornitorinco
polar bear	orso polare
porcupine	porcospino
porpoise	focena
python	pitone
quail	Quaglia
rabbit	coniglio
raccoon	procione
rat	ratto
raven	Corvo
reindeer	renna
rhinoceros	rinoceronte
salamander	salamandra
salmon	salmone
sardine	sardina
scorpion	scorpione
seagull	gabbiano
sea lion	Leone marino
seahorse	cavalluccio marino
seal	foca
shark	squalo
sheep	pecora
shrew	toporagno
skunk	puzzola
sloth	bradipo
snail	lumaca
snake	serpente
spider	ragno
squid	calamaro
squirrel	scoiattolo
starfish	stella di mare
stingray	Stingray
stork	cicogna
swan	cigno
termite	termite
tiger	tigre
toad	rospo
tortoise	tartaruga
turkey	tacchino
turtle	tartaruga
vulture	avvoltoio
walrus	tricheco
warthog	Warthog
wasp	vespa
weasel	donnola
whale	balena
wolf	lupo
wolverine	ghiottone
worm	verme
zebra	zebra
